5200a100a1a0a1a
5300a100a1a0a1a
5400a200a1a0a1a
5500a300a1a0a1a
5600a100a1a0a1a
5800a300a1a0a1a
