2200a100a1a0a1a
2300a100a1a0a1a
2400a200a1a0a1a
2500a300a1a0a1a
2600a100a1a0a1a
2800a300a1a0a1a
