4200a100a1a0a1a
4300a100a1a0a1a
4400a200a1a0a1a
4500a300a1a0a1a
4600a100a1a0a1a
4800a300a1a0a1a
