3200a100a1a0a1a
3300a100a1a0a1a
3400a200a1a0a1a
3500a300a1a0a1a
3600a100a1a0a1a
3800a300a1a0a1a
