1200a100a1a0a1a
1300a100a1a0a1a
1400a200a1a0a1a
1500a300a1a0a1a
1600a100a1a0a1a
1800a300a1a0a1a
