200a100a1a1a1a
300a100a1a1a1a
400a200a1a1a1a
500a300a1a1a1a
600a100a1a1a1a
800a300a1a1a1a
